a fortiori	a foɾˈt̪joɾi
a posteriori	a post̪eˈɾjoɾi
a priori	a ˈpɾjoɾi
abbey national	abˈbej nat̪joˈnal
abbott laboratories	abˈbo t̪laboɾaˈt̪oɾjes
abdullah ii	abˈd̪uʝa d̪os
abn amro holding	ab ˈnamɾo ˈold̪in
abu dhabi	ˈabu ˈd̪abi
abu nidal	ˈabu niˈd̪al
abu sayyaf	ˈabu saʝˈʝaf
action man	ˈakt̪jon man
actividades de construcción y servicios	akt̪ibiˈd̪ad̪es d̪e konst̪ɾukˈsjon i seɾˈbisjos
ad hoc	ad̪ ok
ad infinitum	ad̪ infiniˈt̪um
ad libitum	ad̪ libiˈt̪um
ad nauseam	ad̪ nawseˈam
ad referéndum	ad̪ refeˈɾend̪um
ad valorem	ad̪ baloˈɾem
addis abeba	ˈad̪d̪is aˈbeba
adelphia communications	aˈd̪elpja komuniˈkat̪jons
adobe acrobat	aˈd̪obe akɾoˈbat̪
adobe systems	aˈd̪obeˈ esʝst̪ems
advanced micro devices	ad̪banˈsed̪ˈ mikɾo d̪eˈbises
aerolineas argentinas	aeɾoliˈneas aɾxenˈt̪inas
afp provida	aefeˈ pepɾoˈbid̪a
aguas andinas	ˈagwas anˈd̪inas
aguas argentinas	ˈagwas aɾxenˈt̪inas
aguas de barcelona	ˈagwas d̪e baɾseˈlona
aguas decima	ˈagwas d̪eˈsima
aguas puerto	ˈagwas ˈpweɾt̪o
aguas quinta	ˈagwas ˈkint̪a
air canada	ajɾ kaˈnad̪a
air comet	ajɾ koˈmet̪
air france	ajɾ ˈfɾanse
akzo nobel	ˈakso noˈbel
al ahly	al alʝ
al capone	al kaˈpone
al dente	al ˈd̪ent̪e
alcalá de henares	alkaˈla d̪e eˈnaɾes
alcalá del río	alkaˈla d̪el ˈrio
alfa romeo	ˈalfa roˈmeo
alfonso ugarte	alˈfonso uˈgaɾt̪e
alianza lima	aˈljansa ˈlima
allied domecq	aˈʝjed̪ d̪oˈmek
almirante brown	almiˈɾant̪e bɾown
alta vista	ˈalt̪a ˈbist̪a
alter ego	alˈt̪e ˈɾego
alter egos	alˈt̪e ˈɾegos
alto cachapoal	ˈalt̪o kaʧapoˈal
alto egipto	ˈalt̪o eˈxipt̪o
alto valle	ˈalt̪o ˈbaʝe
américa central	aˈmeɾika senˈt̪ɾal
américa del norte	aˈmeɾika d̪el ˈnoɾt̪e
américa del sur	aˈmeɾika d̪el suɾ
américa latina	aˈmeɾika laˈt̪ina
américa meridional	aˈmeɾika meɾid̪joˈnal
american express	ameˈɾika ˈnekspɾes
american general	ameˈɾikan xeneˈɾal
american international	ameˈɾikan int̪eɾnat̪joˈnal
american power conversion	ameˈɾikan ˈpaweɾ konˈbeɾsjon
amnistía internacional	amnisˈt̪ia int̪eɾnasjoˈnal
amu darya	ˈamu ˈd̪aɾʝa
an najaf	an naˈxaf
andhra pradesh	ˈand̪ɾa pɾaˈd̪eʧ
anglo american	ˈanglo ameˈɾikan
angra dos reis	ˈangɾa d̪os rejs
ann arbor	an aɾˈboɾ
antigua república yugoslava de macedonia	anˈt̪igwa reˈpublika ʝugosˈlaba d̪e maseˈd̪onja
antigua y barbuda	anˈt̪igwa i baɾˈbud̪a
antillas menores	anˈt̪iʝas meˈnoɾes
aol time warner	aoˈele ˈt̪imewaɾˈneɾ
apple computer	ˈapel kompuˈt̪eɾ
applied materials	aˈpljed̪ maˈt̪eɾjals
arabia saudí	aˈɾabja sawˈd̪i
arabia saudita	aˈɾabja sawˈd̪it̪a
archipiélago de los chonos	aɾʧiˈpjelago d̪e los ˈʧonos
argentinos juniors	aɾxenˈt̪inos ˈʝunjoɾs
arias cañete	ˈaɾjas kaˈɲet̪e
atlas copco	ˈat̪las ˈkopko
atlético bucaramanga	aˈt̪let̪iko bukaɾaˈmanga
atlético madrid	aˈt̪let̪iko maˈd̪ɾid̪
atlético quindío	aˈt̪let̪iko kinˈd̪io
au pair	aw pajɾ
audax italiano	ˈawd̪aks it̪aˈljano
aum shinrikyo	awm ʧinˈrikʝo
austin mini	ˈawst̪in ˈmini
australian gas light	awsˈt̪ɾaljan gas lajt̪
autónoma de guadalajara	awˈt̪onoma d̪e gwad̪alaˈxaɾa
azcárraga jean	asˈkaraga ˈxean
bae systems	ˈbae ˈesʝst̪ems
bahía blanca	baˈia ˈblanka
baja california	ˈbaxa kaliˈfoɾnja
baja california sur	ˈbaxa kaliˈfoɾnja suɾ
banca di roma	ˈbanka d̪i ˈroma
banco agrario	ˈbanko aˈgɾaɾjo
banco andino	ˈbanko anˈd̪ino
banco bhif	ˈbanko bif
banco bilbao	ˈbanko bilˈbao
banco bilbao vizcaya	ˈbanko bilˈbao bisˈkaʝa
banco bilbao vizcaya argentaria	ˈbanko bilˈbao bisˈkaʝa aɾxenˈt̪aɾja
banco bradesco	ˈbanko bɾaˈd̪esko
banco de boston	ˈbanko d̪e ˈbost̪on
banco de chile	ˈbanko d̪e ˈʧile
banco de comercio	ˈbanko d̪e koˈmeɾsjo
banco de crédito	ˈbanko d̪e ˈkɾed̪it̪o
banco de crédito e inversiones	ˈbanko d̪e ˈkɾed̪it̪o e inbeɾˈsjones
banco de galicia	ˈbanko d̪e gaˈlisja
banco de galicia y buenos aires	ˈbanko d̪e gaˈlisja i ˈbwenoˈs ajɾes
banco de guatemala	ˈbanko d̪e gwat̪eˈmala
banco de la nación argentina	ˈbanko d̪e la naˈsjon aɾxenˈt̪ina
banco de mendoza	ˈbanko d̪e menˈd̪osa
banco del estado	ˈbanko d̪el esˈt̪ad̪o
banco del pacífico	ˈbanko d̪el paˈsifiko
banco del país	ˈbanko d̪el paˈis
banco do brasil	ˈbanko d̪o bɾaˈsil
banco ganadero	ˈbanko ganaˈd̪eɾo
banco general de negocios	ˈbanko xeneˈɾal d̪e neˈgosjos
banco hipotecario	ˈbanko ipot̪eˈkaɾjo
banco internacional	ˈbanko int̪eɾnasjoˈnal
banco itau	ˈbanko iˈt̪aw
banco latino	ˈbanko laˈt̪ino
banco latinoamericano de exportaciones	ˈbanko lat̪inoameɾiˈkano d̪e ekspoɾt̪aˈsjones
banco mercantil	ˈbanko meɾkanˈt̪il
banco mercurio	ˈbanko meɾˈkuɾjo
banco mundial	ˈbanko munˈd̪jal
banco nacional	ˈbanko nasjoˈnal
banco nacional de méxico	ˈbanko nasjoˈnal d̪e ˈmeksiko
banco patagonia	ˈbanko pat̪aˈgonja
banco regional	ˈbanko rexjoˈnal
banco santander central	ˈbanko sant̪anˈd̪eɾ senˈt̪ɾal
banco santiago	ˈbanko sanˈt̪jago
banco sudamericano	ˈbanko sud̪ameɾiˈkano
banco sudameris	ˈbanko sud̪aˈmeɾis
banco tornquist	ˈbanko t̪oɾˈnkist̪
banco transandino	ˈbankot ̪ɾansanˈd̪ino
banco urquijo	ˈbanko uɾˈkixo
banco wiese	ˈbanko ˈwjese
banja luka	ˈbanxa ˈluka
bank of america	bank af ameˈɾika
bank of new york	bank af newʝoɾk
bank of nova scotia	bank af ˈnoba esˈkot̪ja
bank of scotland	bank af eskoˈt̪land̪
bank one	banˈk one
banque nationale de paris	ˈbanke nat̪joˈnale d̪e ˈpaɾis
barrick gold	baˈrik gold̪
baton rouge	ˈbat̪on ˈrowxe
bbva bancomer	bbba bankoˈmeɾ
bea systems	ˈbea ˈesʝst̪ems
bear stearns	beˈaɾ esˈt̪eaɾns
becton dickinson	ˈbekt̪on d̪iˈkinson
beer sheva	beɾ ˈʧeba
bell atlantic	bel at̪lanˈt̪ik
bell south	bel sowt̪
belo horizonte	ˈbelo oɾiˈsont̪e
benito juárez	beˈnit̪o ˈxwaɾes
bentley continental	benˈt̪lej kont̪inenˈt̪al
berkshire hathaway	beɾˈkʧiɾe at̪aˈwaj
best buy	best̪ buj
bhp billiton	bp biˈʝit̪on
biblioteca del congreso	bibljoˈt̪eka d̪el konˈgɾeso
big ben	big ben
bilz y pap	bils i pap
bin mahfouz	bin maˈfows
black flag	blak flag
blue jean	blu ˈxean
bnp paribas	bnp paˈɾibas
boca del río	ˈboka d̪el ˈrio
bodegas y bebidas	boˈd̪egas i beˈbid̪as
boise cascade	ˈbojse kasˈkad̪e
bon ami	bo ˈnami
bon jovi	bon ˈxobi
bp amoco	bpa ˈmoko
bristol myers squibb	bɾisˈt̪ol mʝeɾse sˈkibb
british airways	bɾiˈt̪iˈʧ ajɾwajs
british american tobacco	bɾiˈt̪iʧ ameˈɾikan t̪oˈbako
british columbia	bɾiˈt̪iʧ koˈlumbja
british petroleum	bɾiˈt̪iʧ pet̪ɾoˈlewm
british telecommunications	bɾiˈt̪iʧ t̪elekomuniˈkat̪jons
broad peak	bɾoˈad̪ pik
buenos aires	ˈbweno ˈsajɾes
burger king	buɾˈxeɾ kin
burkina faso	buɾˈkina ˈfaso
caballo blanco	kaˈbaʝo ˈblanko
cabernet sauvignon	kabeɾˈnet̪ sawˈbignon
cabo de hornos	ˈkabo d̪e ˈoɾnos
cabo verde	ˈkabo ˈbeɾd̪e
cadbury schweppes	kad̪ˈbuɾʝ ˈʧwepes
caja de ahorros	ˈkaxa d̪e aˈoros
caja madrid	ˈkaxa maˈd̪ɾid̪
campo grande	ˈkampo ˈgɾand̪e
can mayor	kan maˈʝoɾ
canada dry	ˈkanad̪a d̪ɾaj
canal de la mancha	kaˈnal d̪e la ˈmanʧa
cape town	ˈkape t̪own
carolina del norte	kaɾoˈlina d̪el ˈnoɾt̪e
carolina del sur	kaɾoˈlina d̪el suɾ
carrizal bajo	kariˈsal ˈbaxo
carson city	ˈkaɾson sit̪ʝ
carta blanca	ˈkaɾt̪a ˈblanka
carta vieja	ˈkaɾt̪a ˈbjexa
caxias do sul	ˈkaksjas d̪o sul
central costanera	senˈt̪ɾal kost̪aˈneɾa
central español	senˈt̪ɾal espaˈɲol
central puerto	senˈt̪ɾal ˈpweɾt̪o
cerro azul	ˈsero aˈsul
cerro castillo	ˈsero kasˈt̪iʝo
cerro porteño	ˈsero poɾˈt̪eɲo
cerro tupungato	ˈsero t̪upunˈgat̪o
charles schwab	ˈʧaɾles ʧwab
chase manhattan	ˈʧase maˈnat̪an
cheung kong	ʧewn kon
chevrolet astro	ʧebɾoˈleˈt̪ ast̪ɾo
chevrolet bel air	ʧebɾoˈlet̪ belajɾ
chevrolet blazer	ʧebɾoˈlet̪ blaˈseɾ
chevrolet camaro	ʧebɾoˈlet̪ kaˈmaɾo
chevrolet celebrity	ʧebɾoˈlet̪ seleˈbɾit̪ʝ
chevrolet chevette	ʧebɾoˈlet̪ ʧeˈbet̪e
chevrolet chevy van	ʧebɾoˈlet̪ ʧebʝban
chevrolet corvette	ʧebɾoˈlet̪ koɾˈbet̪e
chevrolet impala	ʧebɾoˈlet̪ imˈpala
chevrolet lumina	ʧebɾoˈlet̪ luˈmina
chevrolet monza	ʧebɾoˈlet̪ ˈmonsa
chevrolet tahoe	ʧebɾoˈlet̪ t̪aˈoe
chiang mai	ʧjan maj
china mobile	ˈʧina moˈbile
china unicom	ˈʧina uniˈkom
chivas regal	ˈʧibas reˈgal
cho oyu	ʧo ˈoʝu
christian dior	ˈkɾist̪jan d̪joɾ
chrysler neon	kɾʝsleɾ ˈneon
chrysler stratus	kɾʝsleɾ esˈt̪ɾat̪us
chupa chups	ˈʧupa ʧups
cisco systems	ˈsisko ˈesʝst̪ems
citroen ax	siˈt̪ɾoen aks
citroen bx	siˈt̪ɾoen bks
citroen saxo	siˈt̪ɾoen ˈsakso
citroen visa	siˈt̪ɾoen ˈbisa
citroen xantia	siˈt̪ɾoen ˈsant̪ja
citroen xsara	siˈt̪ɾoen ˈsaɾa
citroen zx	siˈt̪ɾoen sks
ciudad bolívar	sjuˈd̪ad̪ boˈlibaɾ
ciudad de guatemala	sjuˈd̪ad̪ d̪e gwat̪eˈmala
ciudad de méxico	sjuˈd̪ad̪ d̪e ˈmeksiko
ciudad del cabo	sjuˈd̪ad̪ d̪el ˈkabo
ciudad del este	sjuˈd̪ad̪ d̪el ˈest̪e
ciudad del vaticano	sjuˈd̪ad̪ d̪el bat̪iˈkano
ciudad juárez	sjuˈd̪ad̪ ˈxwaɾes
close up	ˈklose uˈpe
cms energy	kms eˈneɾgʝ
co ltd	ko lt̪d̪
cola cao	ˈkola ˈkao
colo colo	ˈkolo ˈkolo
colorado springs	koloˈɾad̪o ˈespɾins
comisión internacional de juristas	komiˈsjon int̪eɾnasjoˈnal d̪e xuˈɾist̪as
comité internacional de la cruz roja	komiˈt̪e int̪eɾnasjoˈnal d̪e la kɾus ˈroxa
comodoro rivadavia	komoˈd̪oɾo ribaˈd̪abja
compaq computer	komˈpak kompuˈt̪eɾ
computer associates	kompuˈt̪eɾ asoˈsjat̪es
computer sciences	kompuˈt̪eɾ eˈsjenses
comunidad europea	komuniˈd̪ad̪ ewɾoˈpea
concepción del uruguay	konsepˈsjon d̪el uɾuˈgwaj
confederación suiza	konfed̪eɾaˈsjon ˈswisa
consejo de europa	konˈsexo d̪e ewˈɾopa
consejo de la unión europea	konˈsexo d̪e la uˈnjon ewɾoˈpea
continental airlines	kont̪inenˈt̪ alajɾˈlines
convergencia y unión	konbeɾˈxensja i uˈnjon
coral springs	koˈɾaˈl espɾins
cordillera central	koɾd̪iˈʝeɾa senˈt̪ɾal
cordillera de la costa	koɾd̪iˈʝeɾa d̪e laˈkost̪a
cordillera real	koɾd̪iˈʝeɾa reˈal
corea del norte	koˈɾea d̪el ˈnoɾt̪e
corea del sur	koˈɾea d̪el suɾ
corona austral	koˈɾona awsˈt̪ɾal
corporación financiera	koɾpoɾaˈsjon finanˈsjeɾa
corporación nacional del cobre de chile	koɾpoɾaˈsjon nasjoˈnal d̪el ˈkobɾe d̪e ˈʧile
corpus christi	ˈkoɾpus ˈkɾist̪i
corte europea de derechos humanos	ˈkoɾt̪e ewɾoˈpea d̪e d̪eˈɾeʧos uˈmanos
costa de marfil	ˈkost̪a d̪e maɾˈfil
costa rica	ˈkost̪a ˈrika
credit agricole	kɾeˈd̪it̪ agɾiˈkole
credit lyonnais	kɾeˈd̪it̪ lˈʝonnajs
credit suisse	kɾeˈd̪it̪ ˈswise
cruz azul	kɾus aˈsul
cruz del sur	kɾusd ̪elsuɾ
cruz roja	kɾus ˈroxa
daihatsu charade	d̪aˈjat̪su ʧaˈɾad̪e
daihatsu charmant	d̪aˈjat̪su ʧaɾˈmant̪
daihatsu feroza	d̪aˈjat̪su feˈɾosa
daihatsu rocky	d̪aˈjat̪su rokʝ
daihatsu sirion	d̪aˈjat̪su ˈsiɾjon
daihatsu terios	d̪aˈjat̪su ˈt̪eɾjos
daio paper	ˈd̪ajo ˈpepeɾ
daiwa securities	ˈd̪ajwa sekuˈɾit̪jes
dakota del norte	d̪aˈkot̪a d̪el ˈnoɾt̪e
dakota del sur	d̪aˈkot̪a d̪el suɾ
dalai lama	ˈd̪alaj ˈlama
dar es salaam	d̪aɾ es saˈlam
dassault aviation	d̪aˈsawlt̪ aˈbjat̪jon
datsun bluebird	ˈd̪at̪sun blweˈbiɾd̪
de balzac	d̪e balˈsak
de beauvoir	d̪e beawˈbojɾ
de bergerac	d̪e beɾxeˈɾak
de borda	d̪e ˈboɾd̪a
de bruijn	d̪e bɾwixn
de carlo	d̪e ˈkaɾlo
de champagne	d̪e ʧamˈpagne
de chardin	d̪e ˈʧaɾd̪in
de chateaubriand	d̪e ʧat̪eawˈbɾjand̪
de coubertin	d̪e kowˈbeɾt̪in
de coulomb	d̪e kowˈlomb
de facto	d̪e ˈfakt̪o
de fortabat	d̪e foɾt̪aˈbat̪
de france	d̪e ˈfɾanse
de gaulle	d̪e ˈgawʝe
de givenchy	d̪e xiˈbenʧʝ
de jure	d̪e ˈxuɾe
de la fontaine	d̪e la fonˈt̪ajne
de la hoya	d̪e laˈoʝa
de la rua	d̪e la rwa
de la salle	d̪e la ˈsaʝe
de la tour	d̪e la t̪uɾ
de laclos	d̪e ˈlaklos
de lautréamont	d̪e lawˈt̪ɾeamont̪
de luca	d̪e ˈluka
de marco	d̪e ˈmaɾko
de maupassant	d̪e mawpaˈsant̪
de montaigne	d̪e monˈt̪ajgne
de musset	d̪e muˈset̪
de nerval	d̪e neɾˈbal
de palacio	d̪e paˈlasjo
de re	d̪e re
de rothschild	d̪e rot̪ˈʧild̪
de sade	d̪e ˈsad̪e
de soto	d̪e ˈsot̪o
de talleyrand	d̪e t̪aˈʝeʝɾand̪
de troyes	d̪e ˈt̪ɾoʝes
de villepin	d̪e biˈʝepin
de vries	d̪e ˈbɾies
de witt	d̪e wit̪
dean witter	ˈd̪ean wiˈt̪eɾ
del gato	d̪el ˈgat̪o
del oro	d̪e ˈloɾo
del pino	d̪el ˈpino
del rio	d̪el rjo
del toro	d̪el ˈt̪oɾo
del vecchio	d̪el ˈbekʧjo
dell computer	d̪el kompuˈt̪eɾ
delta air lines	ˈd̪elt̪a ajɾˈlines
delta airlines	ˈd̪elt̪a ajɾˈlines
deportes concepción	d̪eˈpoɾt̪es konsepˈsjon
deportes la serena	d̪eˈpoɾt̪es laseˈɾena
deportes tolima	d̪eˈpoɾt̪es t̪oˈlima
deportes valdivia	d̪eˈpoɾt̪es balˈd̪ibja
deportivo español	d̪epoɾˈt̪ibo espaˈɲol
deportivo pereira	d̪epoɾˈt̪ibo peˈɾejɾa
des moines	d̪es ˈmojnes
deutsche bank	ˈd̪ewʧe bank
deutsche boerse	ˈd̪ewʧe boˈeɾse
deutsche post	ˈd̪ewʧe post̪
deutsche telecom	ˈd̪ewʧe t̪eleˈkom
deutsche telekom	ˈd̪ewʧe t̪eleˈkom
di pietro	d̪i ˈpjet̪ɾo
di prima	d̪i ˈpɾima
di rupo	d̪i ˈrupo
diet coke	ˈd̪aʝet̪ ˈkoke
distribución y servicio	d̪ist̪ɾibuˈsjon i seɾˈbisjo
distrito de columbia	d̪isˈt̪ɾit̪o d̪e koˈlumbja
distrito federal	d̪isˈt̪ɾit̪o fed̪eˈɾal
dom perignon	d̪om peˈɾignon
don lucho	d̪on ˈluʧo
don pedro	d̪on ˈped̪ɾo
dos hermanas	d̪os eɾˈmanas
dow chemical	d̪ow ʧemiˈkal
dow jones	d̪ow ˈxones
dragados y construcciones	d̪ɾaˈgad̪os i konst̪ɾukˈsjones
dresdner bank	d̪ɾesˈd̪neɾ bank
du plessis	d̪u ˈplesis
duke energy	ˈd̪uke eˈneɾgʝ
eastman kodak	eˈast̪man koˈd̪ak
edison international	eˈd̪ison int̪eɾnat̪joˈnal
ee uu	e u
el alamo	el aˈlamo
el alto	e ˈlalt̪o
el baúl	el baˈul
el cairo	el ˈkajɾo
el cajon	el ˈkaxon
el callao	el kaˈʝao
el centro	el ˈsent̪ɾo
el cóndor	el ˈkond̪oɾ
el conquistador	el konkist̪aˈd̪oɾ
el descanso	el d̪esˈkanso
el dorado	el d̪oˈɾad̪o
el encanto	el enˈkant̪o
el ferrol	el feˈrol
el inca	e ˈlinka
el indio	e ˈlind̪jo
el molino	el moˈlino
el monte	el ˈmont̪e
el paso	el ˈpaso
el porvenir	el poɾbeˈniɾ
el salvador	el salbaˈd̪oɾ
el silencio	el siˈlensjo
el soberbio	elsoˈbeɾbjo
el tigre	el ˈt̪igɾe
el tofo	el ˈt̪ofo
el trapiche	el t̪ɾaˈpiʧe
el valle	el ˈbaʝe
el vaticano	el bat̪iˈkano
electricidad de caracas	elekt̪ɾisiˈd̪ad̪ d̪e kaˈɾakas
electronic arts	elekt̪ɾoˈnik aɾt̪s
elefante blanco	eleˈfant̪e ˈblanko
elf aquitaine	elf akiˈt̪ajne
eli lilly	ˈeli lilʝ
elizabeth ii	elisaˈbet̪ d̪os
eloy alfaro	eˈloj alˈfaɾo
embotelladora andina	embot̪eʝaˈd̪oɾa anˈd̪ina
emiratos árabes unidos	emiˈɾat̪oˈs aɾabes uˈnid̪os
empresa nacional de electricidad	emˈpɾesa nasjoˈnal d̪e elekt̪ɾisiˈd̪ad̪
espírito santo	esˈpiɾit̪o ˈsant̪o
espiritu santo	espiˈɾit̪u ˈsant̪o
estado de israel	esˈt̪ad̪o d̪e israˈel
estado de la ciudad del vaticano	esˈt̪ad̪o d̪e la sjuˈd̪ad̪ d̪el bat̪iˈkano
estados federados de micronesia	esˈt̪ad̪os fed̪eˈɾad̪os d̪e mikɾoˈnesja
estados unidos	esˈt̪ad̪os uˈnid̪os
estados unidos de américa	esˈt̪ad̪os uˈnid̪os d̪e aˈmeɾika
estados unidos mexicanos	esˈt̪ad̪os uˈnid̪os meksiˈkanos
esteban echeverría	esˈt̪eban eʧebeˈria
estee lauder	ˈest̪e lawˈd̪eɾ
estrecho de gibraltar	esˈt̪ɾeʧo d̪e xibɾalˈt̪aɾ
estrecho de magallanes	esˈt̪ɾeʧo d̪e magaˈʝanes
estrella blanca	esˈt̪ɾeʝa ˈblanka
eusko alkartasuna	ˈewsko alkaɾt̪aˈsuna
ex aequo	eks aˈekwo
ex profeso	eks pɾoˈfeso
exxon mobil	ˈekskson moˈbil
fannie mae	ˈfannje ˈmae
federación de rusia	fed̪eɾaˈsjon d̪e ˈrusja
federación internacional de derechos humanos	fed̪eɾaˈsjon int̪eɾnasjoˈnal d̪e d̪eˈɾeʧos uˈmanos
fernández vial	feɾˈnand̪es bjal
fernando de la mora	feɾˈnand̪o d̪e la ˈmoɾa
fiat brava	fjat̪ ˈbɾaba
fiat bravo	fjat̪ ˈbɾabo
fiat marea	fjat̪ maˈɾea
fiat punto	fjat̪ ˈpunt̪o
fiat tempra	fjat ̪ˈt̪empɾa
fiat tipo	fjat̪ ˈt̪ipo
fiat uno	fja ˈt̪uno
fidelity investments	fid̪eˈlit̪ʝ inˈbest̪ment̪s
financial times	finanˈsjal ˈt̪imes
first union	fiɾsˈt̪ unjon
fleetboston financial	flet̪ˈbost̪on finanˈsjal
florencio varela	floˈɾensjo baˈɾela
fomento de construcciones y contratas	foˈment̪o d̪e konst̪ɾukˈsjones i konˈt̪ɾat̪as
ford aerostar	foɾd̪ aeɾosˈt̪aɾ
ford escort	foɾd̪ esˈkoɾt̪
ford explorer	foɾd̪ eksploˈɾeɾ
ford falcon	foɾd̪ ˈfalkon
ford fiesta	foɾd̪ ˈfjest̪a
ford focus	foɾd̪ ˈfokus
ford galaxy	foɾd̪ gaˈlaksʝ
ford ka	foɾd̪ ka
ford lincoln	foɾd̪ ˈlinkoln
ford mondeo	foɾd̪ monˈd̪eo
ford motor	foɾd̪ moˈt̪oɾ
ford motor company	foɾd̪ moˈt̪oɾ komˈpanʝ
ford motors	foɾd̪ ˈmot̪oɾs
ford mustang	foɾd̪ ˈmust̪an
ford ranger	foɾd̪ ˈranʝeɾ
ford taurus	foɾd̪ ˈt̪awɾus
ford thunderbird	foɾd̪ ˈt̪and̪eɾbeɾd̪
fort lauderdale	foɾt̪ lawd̪eɾˈd̪ale
fort wayne	foɾt̪ ˈwaʝne
fort worth	foɾt̪ woɾt̪
france telecom	ˈfɾanse t̪eleˈkom
frankfurt am main	fɾanˈkfuɾt̪ am majn
freddie mac	ˈfɾed̪d̪je mak
fuji bank	ˈfuxi bank
fuji heavy industries	ˈfuxi ˈxebi inˈd̪ust̪ɾjes
fuji photo film	ˈfuxi ˈpot̪o film
fujitsu siemens	fuˈxit̪su ˈsjemens
garden city	ˈgaɾd̪en sit̪ʝ
gasherbrum ii	gaʧeɾˈbɾum d̪os
gasoducto nor andino	gasoˈd̪ukt̪o noɾ anˈd̪ino
general dynamics	xeneˈɾal d̪ˈʝnamiks
general electric	xeneˈɾal elekˈt̪ɾik
general electric company	xeneˈɾal elekˈt̪ɾik komˈpanʝ
general mills	xeneˈɾal mils
general motors	xeneˈɾal ˈmot̪oɾs
general roca	xeneˈɾal ˈroka
general san martín	xeneˈɾal san maɾˈt̪in
general santos	xeneˈɾal ˈsant̪os
georgia pacific	xeˈoɾxja pasiˈfik
gimnasia y esgrima	ximˈnasja i esˈgɾima
godoy cruz	goˈd̪oj kɾus
gold coast	gold̪ koˈast̪
goldman sachs	ˈgold̪ mansaʧs
goldman sachs group	ˈgold̪man saʧs gɾowp
golfo de ancud	ˈgolfo d̪e anˈkud̪
golfo de guinea	ˈgolfo d̪e giˈnea
golfo de méxico	ˈgolfo d̪e ˈmeksiko
golfo de penas	ˈgolfo d̪e ˈpenas
golfo pérsico	ˈgolfo ˈpeɾsiko
gonzález álvarez	gonˈsaleˈs albaɾes
gran bretaña	gɾanbɾeˈt̪aɲa
gran canaria	gɾan kaˈnaɾja
gran chaco	gɾan ˈʧako
gran ducado de luxemburgo	gɾan d̪uˈkad̪o d̪e luksemˈbuɾgo
grand rapids	gɾand̪ ˈrapid̪s
grandes lagos	ˈgɾand̪es ˈlagos
grandes ligas	ˈgɾand̪es ˈligas
great britain	gɾeˈat̪ ˈbɾit̪ajn
green bay	gɾen baj
green river	gɾen riˈbeɾ
grosso modo	ˈgɾoso ˈmod̪o
grupo acs	ˈgɾupo aks
grupo carso	ˈgɾupo ˈkaɾso
grupo dragados	ˈgɾupo d̪ɾaˈgad̪os
grupo modelo	ˈgɾupo moˈd̪elo
grupo televisa	ˈgɾupo t̪eleˈbisa
guayana francesa	gwaˈʝana fɾanˈsesa
guinea ecuatorial	giˈnea ekwat̪oˈɾjal
gutiérrez díaz	guˈt̪jeres ˈd̪ias
habeas corpus	aˈbeas ˈkoɾpus
harley davidson	aɾˈle jd̪aˈbid̪son
herrera de noble	eˈreɾa d̪e ˈnoble
herri batasuna	ˈeri bat̪aˈsuna
hewitt associates	eˈwit̪ asoˈsjat̪es
hewlett packard	ewˈlet̪ paˈkaɾd̪
ho chi minh	o ʧi min
home depot	ˈome d̪eˈpot̪
honda accord	ˈond̪a aˈkoɾd̪
honda civic	ˈond̪a siˈbik
honda integra	ˈond̪a inˈt̪egɾa
honda jazz	ˈond̪a ʝas
honda motor	ˈond̪a moˈt̪oɾ
honeywell international	oneˈʝwel int̪eɾnat̪joˈnal
hong kong	on kon
hot dog	xot̪ ˈd̪og
hot dogs	xot̪ ˈd̪ogs
human rigths watch	ˈuman rigt̪s waʧ
huracán buceo	uɾaˈkan buˈseo
hutchison whampoa	uˈʧison wamˈpoa
hynix semiconductor	ʝniks semikond̪ukˈt̪oɾ
hyundai accent	ˈʝund̪ ajakˈsent̪
hyundai elantra	ˈʝund̪aj eˈlant̪ɾa
hyundai motor	ˈʝund̪aj moˈt̪oɾ
hyundai pony	ˈʝund̪aj ponʝ
hyundai scoupe	ˈʝund̪aj esˈkowpe
hyundai sonata	ˈʝund̪aj soˈnat̪a
hyundai stellar	ˈʝund̪aj est̪eˈʝaɾ
imperial chemical industries	impeˈɾjal ʧemiˈkal inˈd̪ust̪ɾjes
imperial tobacco	impeˈɾjal t̪oˈbako
ims health	ims eˈalt̪
in crescendo	in kɾeˈsend̪o
in fieri	in ˈfjeɾi
in fraganti	in fɾaˈgant̪i
in illo tempore	iˈn iʝo t̪emˈpoɾe
in pace	in ˈpase
in re	in re
in situ	in ˈsit̪u
inca kola	ˈin ka ˈkola
ingram micro	inˈgɾam ˈmikɾo
international business machines	int̪eɾnat̪joˈnal buˈsines maˈʧines
international paper	int̪eɾnat̪joˈnal ˈpepeɾ
ipso facto	ˈipso ˈfakt̪o
iron mountain	ˈiɾon ˈmownt̪ajn
isla de la juventud	ˈisla d̪e la xubenˈt̪ud̪
isla de margarita	ˈisla d̪e maɾgaˈɾit̪a
isla grande de chiloé	ˈisla ˈgɾand̪e d̪e ʧiloˈe
isla grande de tierra del fuego	ˈisla ˈgɾand̪e d̪e ˈt̪jera d̪el ˈfwego
isla magdalena	ˈisla magd̪aˈlena
isla margarita	ˈislamaɾgaˈɾit̪a
isla navarino	ˈisla nabaˈɾino
isla norfolk	ˈisla noɾˈfolk
isla riesco	ˈisla ˈrjesko
islas baleares	ˈislas baleˈaɾes
islas británicas	ˈislas bɾiˈt̪anikas
islas caimán	ˈislas kajˈman
islas cook	ˈislas kok
islas falkland	ˈislas falˈkland̪
islas feroe	ˈislas feˈɾoe
islas galápagos	ˈislas gaˈlapagos
islas juan fernández	ˈislas xwanfeɾˈnand̪es
islas malvinas	ˈislas malˈbinas
islas marshall	ˈislas ˈmaɾʧal
islas salomón	ˈislas saloˈmon
islas vírgenes	ˈislas ˈbiɾxenes
islas vírgenes británicas	ˈislas ˈbiɾxenes bɾiˈt̪anikas
izquierda unida	isˈkjeɾd̪a uˈnid̪a
jack daniels	xak ˈd̪anjels
jaguar xkr	xaˈgwaɾ skɾ
jan mayen	xan ˈmaʝen
japan airlines	ˈxapan ajɾˈlines
japan telecom	ˈxapan t̪eleˈkom
japan tobacco	ˈxapan t̪oˈbako
jc penney	xk penˈnej
jc penny	xk pennʝ
jds uniphase	xd̪s uniˈpase
jeep cherokee	ʝip ʧeˈɾoke
jeep wrangler	ʝip wɾanˈgleɾ
jemaah islamiya	ˈxema islaˈmiʝa
jerez de la frontera	xeˈɾes d̪e la fɾonˈt̪eɾa
jersey city	xeɾˈsej sit̪ʝ
jockey club	ˈʝoki klub
johnnie walker	ˈxonnje ˈwalkeɾ
jorge wilsterman	ˈxoɾxe wilsˈt̪eɾman
josé gálvez	xoˈse ˈgalbes
jp morgan	xp ˈmoɾgan
jp morgan chase	xp ˈmoɾgan ˈʧase
juan carlos i	xwan ˈkaɾlosi
juan de dios	xwan d̪e d̪jos
juan josé	xwan xoˈse
juiz de fora	xwis d̪e ˈfoɾa
juniper networks	xuniˈpeɾ ˈnet̪woɾks
kansas city	ˈkansas sit̪ʝ
khan yunis	kan ˈʝunis
khmer rouge	kmeɾ ˈrowxe
khon kaen	kon ˈkaen
kia motors	kja ˈmot̪oɾs
kimberly clark	kimˈbeɾlʝ klaɾk
knight ridder	kniˈgut ̪rid̪ˈd̪eɾ
korean air	koˈɾean ajɾ
kraft foods	kɾaft̪ fod̪s
kuala lumpur	ˈkwala lumˈpuɾ
la caixa	la ˈkajksa
la carlota	la kaɾˈlot̪a
la cartuja	la kaɾˈt̪uxa
la coronilla	la koɾoˈniʝa
la coruña	la koˈɾuɲa
la escala	la esˈkala
la esperanza	la espeˈɾansa
la espina	la esˈpina
la europea	la ewɾoˈpea
la favorita	la faboˈɾit̪a
la fragua	la ˈfɾagwa
la gruta	la ˈgɾut̪a
la guardia	la ˈgwaɾd̪ja
la habana	la aˈbana
la haya	la ˈaʝa
la interamericana	la int̪eɾameɾiˈkana
la jolla	la ˈxoʝa
la joya	la ˈxoʝa
la laguna	la laˈguna
la mancha	la ˈmanʧa
la matanza	la maˈt̪ansa
la paz	la pas
la plata	la ˈplat̪a
la rioja	la ˈrjoxa
la rochelle	la roˈʧeʝe
la romana	la roˈmana
la serena	la seˈɾena
la union	la ˈunjon
laboratorio chile	laboɾaˈt̪oɾjoˈʧile
lada niva	ˈlad̪aˈniba
lada samara	ˈlad̪a saˈmaɾa
lago general carrera	ˈlago xeneˈɾal kaˈreɾa
lago llanquihue	ˈlago ʝanˈkiwe
lago titicaca	ˈlago t̪it̪iˈkaka
lake erie	ˈlake ˈeɾje
land rover	land̪ roˈbeɾ
land rover freelander	land̪ roˈbeɾ fɾelanˈd̪eɾ
las heras	la ˈseɾas
las lomitas	las loˈmit̪as
las palmas de gran canaria	las ˈpalmas d̪e gɾan kaˈnaɾja
las piñas	las ˈpiɲas
las tinajas	las t̪iˈnaxas
las tórtolas	las ˈt̪oɾt̪olas
las vegas	las ˈbegas
lázaro cárdenas	ˈlasaɾo ˈkaɾd̪enas
le havre	le ˈabɾe
le mans	le mans
le pen	le pen
legg mason	legg ˈmason
lehman brothers holdings	ˈleman ˈbɾot̪eɾ ˈsold̪ins
lejano oriente	leˈxano oˈɾjent̪e
lend lease	lend̪ leˈase
lexmark international	leksˈmaɾk int̪eɾnat̪joˈnal
lg electronics	lg elekˈt̪ɾoniks
liberty media	liˈbeɾt̪ʝ ˈmed̪ja
life insurance	ˈlife insuˈɾanse
liga deportiva universitaria	ˈliga d̪epoɾˈt̪iba unibeɾsiˈt̪aɾja
lincoln continental	ˈlinkoln kont̪inenˈt̪al
little rock	ˈlit̪le rok
lloyds tsb	ʝoʝd̪s t̪sb
lockheed martin	loˈked̪ ˈmaɾt̪in
loma negra	ˈloma ˈnegɾa
lomas de zamora	ˈlomas d̪e saˈmoɾa
long beach	lon beˈaʧ
long island	lon isˈland̪
los alamos	los aˈlamos
los angeles	los anˈxeles
los arcos	lo ˈsaɾkos
los barrios	los ˈbarjos
los cabos	los ˈkabos
los gatos	los ˈgat̪os
los molinos	los moˈlinos
los vilos	los ˈbilos
louis vuitton	ˈlowis ˈbwit̪on
lucent technologies	luˈsent̪ t̪eʧnoˈloxjes
lucky strike	lukʝ esˈt̪ɾike
luis calvo	lwis ˈkalbo
luz del sur	lus d̪el suɾ
m a n	ˈeme a ˈene
madre de dios	ˈmad̪ɾe d̪e d̪jos
malta morenita	ˈmalt̪a moɾeˈnit̪a
malvinas argentinas	malˈbinas aɾxenˈt̪inas
mar adriático	maɾ ad̪ɾiˈat̪iko
mar amarillo	ma ɾamaˈɾiʝo
mar báltico	maɾ ˈbalt̪iko
mar caribe	maɾ kaˈɾibe
mar caspio	maɾ ˈkaspjo
mar de bering	maɾ d̪eˈbeɾin
mar del norte	maɾ d̪elˈnoɾt̪e
mar del plata	maɾ d̪elˈplat̪a
mar mediterráneo	maɾ med̪it̪eˈraneo
mar muerto	maɾ ˈmweɾt̪o
mar negro	maɾ ˈnegɾo
mar rojo	maɾ ˈroxo
mar tirreno	maɾ t̪iˈreno
marathon oil	maˈɾat̪on ojl
martha stewart living	ˈmaɾt̪a est̪eˈwaɾt̪ ˈlibin
martínez martínez	maɾˈt̪ines maɾˈt̪ines
maserati spyder	maseˈɾat̪ie spˈʝd̪eɾ
matsushita electric	mat̪suˈʧit̪a elekˈt̪ɾik
matsushita electric industrial	mat̪suˈʧit̪a elekˈt̪ɾik ind̪usˈt̪ɾjal
mauna kea	ˈmawna ˈkea
max factor	maks fakˈt̪oɾ
mazda mpv	ˈmasd̪a mpb
mci worldcom	ˈmaki woɾlˈd̪kom
mea culpa	ˈmea ˈkulpa
medina del campo	meˈd̪ina d̪el ˈkampo
merrill lynch	meˈrill ʝnʧ
mexico city	mekˈsiko sit̪ʝ
micron technology	ˈmikɾon t̪eʧnoˈlogʝ
milton keynes	ˈmilt̪on ˈkeʝnes
miramar misiones	miɾaˈma ɾmiˈsjones
mitsubishi colt	mit̪suˈbiʧi kolt̪
mitsubishi electric	mit̪suˈbiʧi elekˈt̪ɾik
mitsubishi galant	mit̪suˈbiʧi gaˈlant̪
mitsubishi lancer	mit̪suˈbiʧi lanˈseɾ
mitsubishi motors	mit̪suˈbiʧi ˈmot̪oɾs
mitsubishi pajero	mit̪suˈbiʧ ipaˈxeɾo
mitsubishi tokyo financial	mit̪suˈbiʧi ˈt̪okʝo finanˈsjal
mizuho financial	ˈmiswo finanˈsjal
mizuho holdings	ˈmiswo ˈold̪ins
mm hg	m̩ː g
mohamed ali	moaˈmeˈd ̪ali
mont blanc	mont̪ blank
montañas azules	monˈt̪aɲas aˈsules
montañas rocosas	monˈt̪aɲas roˈkosas
monte grande	ˈmont̪e ˈgɾand̪e
monte olimpo	ˈmont̪e oˈlimpo
montes urales	ˈmont̪es uˈɾales
morgan stanley	ˈmoɾgan est̪anˈlej
motu proprio	ˈmot̪u ˈpɾopɾjo
mountain bike	ˈmownt̪ajn ˈbike
munich re	muˈniʧ re
mutatis mutandis	muˈt̪at̪is muˈt̪and̪is
nacional de drogas	nasjoˈnal d̪e ˈd̪ɾogas
nacional financiera	nasjoˈnal finanˈsjeɾa
naciones unidas	naˈsjones uˈnid̪as
nanda devi	ˈnand̪a ˈd̪ebi
nanga parbat	ˈnanga paɾˈbat̪
national bank of canada	nat̪joˈnal bank af kaˈnad̪a
national city	nat̪joˈnal sit̪ʝ
national grid	nat̪joˈnal gɾid̪
national semiconductor	nat̪joˈnal semikond̪ukˈt̪oɾ
neiman marcus	ˈnejman ˈmaɾkus
network appliance	neˈt̪woɾk aˈpljanse
new brunswick	new bɾunˈswik
new hampshire	new amˈpʧiɾe
new haven	ne ˈwaben
new jersey	new xeɾˈsej
new mexico	new mekˈsiko
new orleans	new oɾˈleans
new south wales	new sowt ̪ˈwales
new york	new ʝoɾk
new york times	new ʝoɾk ˈt̪imes
newmont mining	newˈmont̪ ˈminin
nextel communications	neksˈt̪el komuniˈkat̪jons
nh hoteles	n oˈt̪eles
nippon mining	ˈnipon ˈminin
nippon steel	ˈnipon esˈt̪el
nissan bluebird	ˈnisan blweˈbiɾd̪
nissan king	ˈnisan kin
nissan maxima	ˈnisan makˈsima
nissan motor	ˈnisan moˈt̪oɾ
nissan patrol	ˈnisan paˈt̪ɾol
nissan primera	ˈnisan pɾiˈmeɾa
nissan sunny	ˈnisan sunnʝ
nissan terrano	ˈnisan t̪eˈrano
nombre oficial	ˈnombɾe ofiˈsjal
norsk hydro	noɾsk ʝd̪ɾo
nortel networks	noɾˈt̪el ˈnet̪woɾks
north carolina	noɾt̪ kaɾoˈlina
north island	noɾt̪is ˈland̪
northern mariana islands	ˈnoɾt̪eɾn maˈɾjana ˈislans
northern trust	ˈnoɾt̪eɾn t̪ɾust̪
northrop grumman	noɾˈt̪ɾop ˈgɾuman
northwest airlines	noɾˈt̪west̪ ajɾˈlines
nova scotia	ˈnoba esˈkot̪ja
novi sad	ˈnobi sad̪
nuestra señora del pilar	ˈnwest̪ɾa seˈɲoɾa d̪el piˈlaɾ
nueva caledonia	ˈnweba kaleˈd̪onja
nueva delhi	ˈnweba ˈd̪eli
nueva hampshire	ˈnweba amˈpʧiɾe
nueva jersey	ˈnweba xeɾˈsej
nueva méxico	ˈnweba ˈmeksiko
nueva renca	ˈnweba ˈrenka
nueva york	ˈnweba ʝoɾk
nueva zelanda	ˈnweba seˈland̪a
nuevo laredo	ˈnwebo laˈɾed̪o
nuevo méxico	ˈnwebo ˈmeksiko
obrascón huarte lain	obɾasˈkon ˈwaɾt̪e lajn
occidental petroleum	oksid̪enˈt̪al pet̪ɾoˈlewm
océano atlántico	oˈseano aˈt̪lant̪iko
océano indico	oˈseano inˈd̪iko
océano índico	oˈseano ˈind̪iko
océano pacífico	oˈseano paˈsifiko
office depot	ˈofis d̪eˈpot̪
oklahoma city	oklaˈoma sit̪ʝ
old spice	old̪ esˈpise
once caldas	ˈons eˈkald̪as
opel astra	oˈpe ˈlast̪ɾa
opel combo	oˈpel ˈkombo
opel corsa	oˈpel ˈkoɾsa
opel kadett	oˈpel kaˈd̪et̪
opel omega	oˈpel oˈmega
opel vectra	oˈpel ˈbekt̪ɾa
orange crush	ˈoɾanʧ kɾaʧ
oriente petrolero	oˈɾjent̪e pet̪ɾoˈleɾo
oriente próximo	oˈɾjent̪e ˈpɾoksimo
orioles de baltimore	oˈɾjoles d̪e balt̪iˈmoɾe
oro negro	ˈoɾoˈnegɾo
osa mayor	ˈosa maˈʝoɾ
oso negro	ˈosoˈnegɾo
pacific bell	pasiˈfik bel
pacific ocean	pasiˈfik oˈsean
países bajos	paˈises ˈbaxos
palma de mallorca	ˈpalma d̪e maˈʝoɾka
palmerston north	palˈmeɾst̪on noɾt̪
palo verde	ˈpalo ˈbeɾd̪e
panama city	paˈnama sit̪ʝ
panchen lama	ˈpanʧen ˈlama
papua nueva guinea	ˈpapwa ˈnweba giˈnea
parlamento europeo	paɾlaˈment̪o ewɾoˈpeo
partido nacionalista vasco	paɾˈt̪id̪o nasjonaˈlist̪a ˈbasko
partido popular	paɾˈt̪id̪o popuˈlaɾ
partido socialista obrero español	paɾˈt̪id̪o sosjaˈlist̪a oˈbɾeɾo espaˈɲol
paso de los libres	ˈpaso d̪e los ˈlibɾes
paso de los toros	ˈpaso d̪e los ˈt̪oɾos
patricio lynch	paˈt̪ɾisjo lʝnʧ
pavo real	ˈpabo reˈal
pecom energía	peˈkom eneɾˈxia
península de taitao	peˈninsula d̪e t̪ajˈt̪ao
pepsi cola	ˈpepsi ˈkola
pepsi light	ˈpepsi lajt̪
per se	peɾ se
perez companc	peˈɾes komˈpank
pérez companc	ˈpeɾes komˈpank
pernod ricard	peɾˈnod̪ riˈkaɾd̪
petroleos de venezuela	pet̪ɾoˈleos d̪e beneˈswela
peugeot partner	pewxeˈot̪ paɾt̪ˈneɾ
phelps dodge	pelps ˈd̪od̪xe
philip morris	piˈlip ˈmoris
philips electronics	ˈpilips elekˈt̪ɾoniks
phillips petroleum	ˈpiʝips pet̪ɾoˈlewm
phnom penh	pnom pen
piedra del aguila	ˈpjed̪ɾa d̪el aˈgila
piedras negras	ˈpjed̪ɾas ˈnegɾas
pilsener cristal	pilseˈneɾ kɾisˈt̪al
pinar del río	piˈnaɾ d̪el ˈrio
pizza hut	ˈpisa ut̪
placer dome	plaˈseɾ ˈd̪ome
plus ultra	plu ˈsult̪ɾa
poco a poco	ˈpoko aˈpoko
polinesia francesa	poliˈnesja fɾanˈsesa
polo norte	ˈpolo ˈnoɾt̪e
polo ralph lauren	ˈpolo ralp ˈlawɾen
polo sur	ˈpolo suɾ
pontiac firebird	ponˈt̪jak fiɾeˈbiɾd̪
pontiac gto	ponˈt̪jak gt̪o
por si acaso	poɾ si aˈkaso
port louis	poɾt̪ ˈlowis
port moresby	poɾt̪ moˈɾesbʝ
porto alegre	ˈpoɾt̪o aˈlegɾe
porto velho	ˈpoɾt̪o ˈbelo
portugal telecom	poɾt̪uˈgal t̪eleˈkom
post mortem	post̪ moɾˈt̪em
principado de liechtenstein	pɾinsiˈpad̪o d̪e ljeʧˈt̪enst̪ejn
principado de mónaco	pɾinsiˈpad̪o d̪e ˈmonako
principal financial	pɾinsiˈpalf inanˈsjal
pro forma	pɾo ˈfoɾma
prudential financial	pɾud̪enˈt̪jal finanˈsjal
public service enterprise	puˈblik seɾˈbise ent̪eɾˈpɾise
puente alto	ˈpwent̪e ˈalt̪o
puerto asís	ˈpweɾt̪o aˈsis
puerto cabello	ˈpweɾt̪o kaˈbeʝo
puerto españa	ˈpweɾt̪o esˈpaɲa
puerto maldonado	ˈpweɾt̪o mald̪oˈnad̪o
puerto montt	ˈpweɾt̪o mont̪
puerto príncipe	ˈpweɾt̪o ˈpɾinsipe
puerto rico	ˈpweɾt̪o ˈriko
puerto stanley	ˈpweɾt̪o est̪anˈlej
puerto vallarta	ˈpweɾt̪o baˈʝaɾt̪a
puerto varas	ˈpweɾt̪o ˈbaɾas
puna de atacama	ˈpuna d̪e at̪aˈkama
punta arenas	ˈpunt̪a aˈɾenas
punta lavapié	ˈpunt̪a labaˈpje
punto fijo	ˈpunt̪o ˈfixo
qantas airways	ˈqant̪a ˈsajɾwajs
quid pro quo	kid̪ pɾo kwo
quintana roo	kinˈt̪ana ro
qwest communications	qˈwest̪ komuniˈkat̪jons
ramat gan	raˈmat̪ gan
rampla juniors	ˈrampla ˈʝunjoɾs
range rover	ˈranxe roˈbeɾ
rapa nui	ˈrapa nuj
real madrid	reˈal maˈd̪ɾid̪
real santa cruz	reˈal ˈsant̪a kɾus
reckitt benckiser	reˈkit̪ benkiˈseɾ
reina victoria	ˈrejna bikˈt̪oɾja
reino de españa	ˈrejno d̪e esˈpaɲa
reino de los países bajos	ˈrejno d̪e los paˈises ˈbaxos
reino de suecia	ˈrejno d̪e ˈswesja
reino de tailandia	ˈrejno d̪e t̪ajˈland̪ja
reino unido	ˈrejno uˈnid̪o
reino unido de gran bretaña e irlanda del norte	ˈrejno uˈnid̪o d̪e gɾan bɾeˈt̪aɲa e iɾˈland̪a d̪el ˈnoɾt̪e
renault clio	reˈnawlt̪ kljo
renault kangoo	reˈnawlt̪ ˈkango
renault laguna	reˈnawlt̪ laˈguna
renault megane	reˈnawlt̪ meˈgane
renault scenic	reˈnawlt̪ eseˈnik
renault twingo	reˈnawlt̪ ˈt̪wingo
repsol ypf	repˈsol ʝpf
república argentina	reˈpublika aɾxenˈt̪ina
república bolivariana de venezuela	reˈpublika bolibaˈɾjana d̪e beneˈswela
república centroafricana	reˈpublika sent̪ɾoafɾiˈkana
república checa	reˈpublika ˈʧeka
república de bolivia	reˈpublika d̪e boˈlibja
república de chile	reˈpublika d̪e ˈʧile
república de chipre	reˈpublika d̪e ˈʧipɾe
república de colombia	reˈpublika d̪e koˈlombja
república de corea	reˈpublika d̪e koˈɾea
república de costa rica	reˈpublika d̪e ˈkost̪aˈrika
república de croacia	reˈpublika d̪e kɾoˈasja
república de cuba	reˈpublika d̪e ˈkuba
república de el salvador	reˈpublika d̪e elsalbaˈd̪oɾ
república de filipinas	reˈpublika d̪e filiˈpinas
república de guatemala	reˈpublika d̪egwat̪eˈmala
república de honduras	reˈpublika d̪e onˈd̪uɾas
república de hungría	reˈpublika d̪e unˈgɾia
república de indonesia	reˈpublika d̪e ind̪oˈnesja
república de panamá	reˈpublika d̪e panaˈma
república de polonia	reˈpublika d̪e poˈlonja
república de turquía	reˈpublika d̪e t̪uɾˈkia
república del congo	reˈpublika d̪el ˈkongo
república del ecuador	reˈpublika d̪el ekwaˈd̪oɾ
república del paraguay	reˈpublika d̪el paɾaˈgwaj
república del perú	reˈpublika d̪el peˈɾu
república democrática del congo	reˈpublika d̪emoˈkɾat̪ika d̪el ˈkongo
republica dominicana	repuˈblika d̪ominiˈkana
república dominicana	reˈpublika d̪ominiˈkana
república eslovaca	reˈpublika esloˈbaka
república federal de alemania	reˈpublika fed̪eˈɾal d̪e aleˈmanja
república federativa de brasil	reˈpublika fed̪eɾaˈt̪iba d̪e bɾaˈsil
república francesa	reˈpublika fɾanˈsesa
república islámica de irán	reˈpublika isˈlamika d̪e iˈɾan
república italiana	reˈpublika it̪aˈljana
república oriental del uruguay	reˈpublika oɾjenˈt̪al d̪el uɾuˈgwaj
república popular china	reˈpublika popuˈlaɾ ˈʧina
república socialista de vietnam	reˈpublika sosjaˈlist̪a d̪e bjet̪ˈnam
resona holdings	reˈsona ˈold̪ins
rhode island	ˈrod̪e isˈland̪
río amarillo	ˈrio amaˈɾiʝo
rio branco	rjo ˈbɾanko
río bravo	ˈrio ˈbɾabo
rio claro	rjo ˈklaɾo
río cuarto	ˈrio ˈkwaɾt̪o
rio de janeiro	rjo d̪e xaˈnejɾo
río de la plata	ˈrio d̪e laˈplat̪a
río gallegos	ˈrio gaˈʝegos
rio grande	rjo ˈgɾand̪e
río grande del norte	ˈrio ˈgɾand̪ed̪elˈnoɾt̪e
rio negro	rjo ˈnegɾo
río negro	ˈrio ˈnegɾo
rio tinto	rjo ˈt̪int̪o
rio verde	rjo ˈbeɾd̪e
river plate	ri ˈbeɾˈplat̪e
rockwell automation	ro ˈkwelawt̪oˈmat̪jon
rodríguez ramos	ro ˈd̪ɾigesˈramos
rolling stones	ˈroʝin esˈt̪ones
rosa emilia	ˈrosa eˈmilja
royal bank of canada	roˈʝal bank af kaˈnad̪a
royal bank of scotland	roˈʝal bank af eskoˈt̪land̪
royal dutch shell	roˈʝal d̪uʧ ʧel
royal kpn	roˈʝal kpn
royal sun alliance	roˈʝal sun aˈʝjanse
saint gallen	sajnt ̪ˈgaʝen
saint george	sajnt ̪xeˈoɾxe
saint john	sajnt ̪ʝon
saint lawrence	sajnt ̪lawˈɾense
saint louis	sajnt̪ ˈlowis
saint paul	sajnt ̪pawl
saint petersburg	sajnt̪ pet̪eɾsˈbuɾg
salar de atacama	saˈlaɾ d̪e at̪aˈkama
salar de uyuni	saˈlaɾ d̪e uˈʝuni
salinas pliego	saˈlinas ˈpljego
sallent de gállego	saˈʝent̪ d̪e ˈgaʝego
salt lake city	salt̪ ˈlake sit̪ʝ
samoa americana	saˈmoa ameɾiˈkana
samoa occidental	saˈmoa oksid̪enˈt̪al
samsung electronics	ˈsamsun elekˈt̪ɾoniks
san agustín	san agusˈt̪in
san andrés	san anˈd̪ɾes
san antonio	san anˈt̪onjo
san bernardino	san beɾnaɾˈd̪ino
san bernardo	san beɾˈnaɾd̪o
san borja	san ˈboɾxa
san buenaventura	san bwenabenˈt̪uɾa
san carlos	san ˈkaɾlos
san carlos de bariloche	san ˈkaɾlos d̪e baɾiˈloʧe
san clemente	san kleˈment̪e
san cristobal	san kɾist̪oˈbal
san cristóbal	san kɾisˈt̪obal
san cristóbal de las casas	san kɾisˈt̪obal d̪e las ˈkasas
san diego	san ˈd̪jego
san esteban	san esˈt̪eban
san felipe	san feˈlipe
san fernando	san feɾˈnand̪o
san francisco	san fɾanˈsisko
san gil	san xil
san ignacio	san igˈnasjo
san isidro	san iˈsid̪ɾo
san jacinto	san xaˈsint̪o
san javier	san xaˈbjeɾ
san jose	san ˈxose
san josé	san xoˈse
san juan	san xwan
san justo	san ˈxust̪o
san leonardo	san leoˈnaɾd̪o
san lorenzo	san loˈɾenso
san lorenzo de almagro	san loˈɾensod̪ealˈmagɾo
san lucas	san ˈlukas
san luis	san lwis
san luis obispo	san lwis oˈbispo
san luis potosí	san lwis pot̪oˈsi
san mamés	san maˈmes
san marcos	san ˈmaɾkos
san marino	san maˈɾino
san martín	san maɾˈt̪in
san mateo	san maˈt̪eo
san miguel	sanmiˈgel
san miguel de tucumán	san miˈgel d̪e t̪ukuˈman
san nicolás	san nikoˈlas
san pablo	san ˈpablo
san pedro	san ˈped̪ɾo
san pedro de alcántara	san ˈped̪ɾo d̪e alˈkant̪aɾa
san pedro sula	san ˈped̪ɾo ˈsula
san rafael	san rafaˈel
san román	san roˈman
san roque	san ˈroke
san salvador	san salbaˈd̪oɾ
san salvador de jujuy	san salbaˈd̪oɾ d̪e xuˈxuj
san sebastián	san sebast̪iˈan
san silvestre	san silˈbest̪ɾe
san telmo	san ˈt̪elmo
san vicente	san biˈsent̪e
san vicente y las granadinas	san biˈsent̪e i las gɾanaˈd̪inas
sanpaolo imi	sanpaˈolo ˈimi
sant joan	sant̪ ˈxoan
sant josep	sant̪ xoˈsep
santa ana	ˈsant̪a ˈana
santa catalina	ˈsant̪a kat̪aˈlina
santa catarina	ˈsant̪a kat̪aˈɾina
santa cecilia	ˈsant̪a seˈsilja
santa clara	ˈsant̪a ˈklaɾa
santa cruz	ˈsant̪a kɾus
santa cruz de la sierra	ˈsant̪a kɾus d̪e la ˈsjera
santa cruz de tenerife	ˈsant̪a kɾus d̪e t̪eneˈɾife
santa elena	ˈsant̪a eˈlena
santa fe	ˈsant̪a fe
santa fé	ˈsant̪a fe
santa fe de bogotá	ˈsant̪a fe d̪e bogoˈt̪a
santa helena	ˈsant̪a eˈlena
santa isabel	ˈsant̪a isaˈbel
santa lucía	ˈsant̪a luˈsia
santa maria	ˈsant̪a ˈmaɾja
santa marta	ˈsant̪a ˈmaɾt̪a
santa monica	ˈsant̪a moˈnika
santa rita	ˈsant̪a ˈrit̪a
santa rosa	ˈsant̪a ˈrosa
santa sede	ˈsant̪a ˈsed̪e
santafé de bogotá	sant̪aˈfe d̪e bogoˈt̪a
santander central hispano	sant̪anˈd̪eɾ senˈt̪ɾal isˈpano
santiago de chile	sanˈt̪jago d̪e ˈʧile
santiago de compostela	sanˈt̪jago d̪e komposˈt̪ela
santiago de cuba	sanˈt̪jago d̪e ˈkuba
santiago del estero	sanˈt̪jago d̪el esˈt̪eɾo
santo andré	ˈsant̪o anˈd̪ɾe
santo domingo	ˈsant̪o d̪oˈmingo
santo domingo de guzmán	ˈsant̪o d̪oˈmingo d̪e gusˈman
santo tomás	ˈsant̪o t̪oˈmas
santo tomé	ˈsant̪o t̪oˈme
santo tomé y príncipe	ˈsant̪o t̪oˈme i ˈpɾinsipe
são paulo	ˈsao ˈpawlo
sara lee	ˈsaɾa le
sbc communications	esbk komuniˈkat̪jons
schneider electric	ʧnejˈd̪eɾ elekˈt̪ɾik
seat cordoba	seˈat̪ koɾˈd̪oba
seat ibiza	seˈat̪ iˈbisa
sello rojo	ˈseʝo ˈroxo
selva negra	ˈselba ˈnegɾa
sempra energy	ˈsempɾa eˈneɾgʝ
sendero luminoso	senˈd̪eɾo lumiˈnoso
serbia y montenegro	ˈseɾbja i mont̪eˈnegɾo
seven up	seb eˈnap
shah alam	ʧa aˈlam
si acaso	si aˈkaso
siebel systems	sjeˈbeˈl esʝst̪ems
sierra gorda	ˈsjera ˈgoɾd̪a
sierra leona	ˈsjera leˈona
sierra madre	ˈsjera ˈmad̪ɾe
sine die	ˈsine d̪je
singapore airlines	singaˈpoɾe ajɾˈlines
sk telecom	esk t̪eleˈkom
skoda fabia	esˈkod̪a ˈfabja
skoda octavia	esˈkod̪a okˈt̪abja
societe generale	soˈsjet̪ exeneˈɾale
sol de américa	sol d̪e aˈmeɾika
south australia	sowt ̪awsˈt̪ɾalja
south bend	sowt̪ bend̪
south carolina	sowt̪ kaɾoˈlina
south dakota	sowt̪ d̪aˈkot̪a
south georgia	sowt̪ xeˈoɾxja
southern peru copper	ˈsowt̪eɾn ˈpeɾu koˈpeɾ
southwest airlines	sowt̪ˈwest̪ ajɾˈlines
sport boys	esˈpoɾt̪ bojs
sport colombia	esˈpoɾt̪ koˈlombja
sporting cristal	esˈpoɾt̪ inkɾisˈt̪al
sprint pcs	esˈpɾint̪ peˈses
sri lanka	ˈesri ˈlanka
ssangyong motor	ˈsangʝon moˈt̪oɾ
standard chartered	est̪anˈd̪aɾd̪ ʧaɾt̪eˈɾed̪
state street	esˈt̪at̪e esˈt̪ɾet̪
subaru forester	suˈbaɾu foɾesˈt̪eɾ
subaru impreza	suˈbaɾu imˈpɾesa
subaru legacy	suˈbaɾu leˈgakʝ
suez lyonnaise	swes lʝonˈnajse
sui generis	suj xeˈneɾis
sumitomo mitsui banking	sumiˈt̪omo mit̪ˈsuj ˈbankin
sun hung kai properties	sun un kaj pɾoˈpeɾt̪jes
sun microsystems	sun miˈkɾosʝst̪ems
supermercados unimarc	supeɾmeɾˈkad̪os uniˈmaɾk
suzuki baleno	suˈsuki baˈleno
suzuki samurai	suˈsuki saˈmuɾaj
suzuki sj	suˈsuki esx
suzuki swift	suˈsuki swift̪
suzuki vitara	suˈsuki biˈt̪aɾa
swiss re	swis re
tai po	t̪aj po
taiwan semiconductor	ˈt̪ajwan semikond̪ukˈt̪oɾ
tal vez	t̪al bes
tech data	t̪eʧ ˈd̪at̪a
teixeira de freitas	t̪ejkˈsejɾa d̪e ˈfɾejt̪as
terra lycos	ˈt̪era lʝkos
texas instruments	ˈt̪eksas insˈt̪ɾument̪s
the hague	t̪e ˈage
the strongest	t̪e est̪ɾonˈxest̪
thomson multimedia	ˈt̪omson mult̪iˈmed̪ja
thousand oaks	t̪owˈsanˈd̪ oaks
thyssen krupp	t̪ʝsen kɾup
tierra del fuego	ˈt̪jera d̪el ˈfwego
timor oriental	t̪iˈmoɾ oɾjenˈt̪al
tingo maría	ˈt̪ingo maˈɾia
tokyo electron	ˈt̪okʝo eˈlekt̪ɾon
total fina elf	t̪oˈt̪al ˈfina elf
totalfina elf	t̪ot̪alˈfina elf
toyota camry	t̪oˈʝot̪a kamɾʝ
toyota celica	t̪oˈʝot̪a seˈlika
toyota corolla	t̪oˈʝot̪a koˈɾoʝa
toyota corona	t̪oˈʝot̪a koˈɾona
toyota dyna	t̪oˈʝot̪a d̪ʝna
toyota hiace	t̪oˈʝot̪a ˈjase
toyota hilux	t̪oˈʝot̪a ˈiluks
toyota motor	t̪oˈʝot̪a moˈt̪oɾ
toyota starlet	t̪oˈʝot̪a est̪aɾˈlet̪
toyota supra	t̪oˈʝot̪a ˈsupɾa
toyota tercel	t̪oˈʝot̪a t̪eɾˈsel
toyota yaris	t̪oˈʝot̪a ˈʝaɾis
tres arroyos	t̪ɾes aˈroʝos
tres coronas	t̪ɾes koˈɾonas
tres cruces	t̪ɾes ˈkɾuses
tres de febrero	t̪ɾes d̪efeˈbɾeɾo
tres esquinas	t̪ɾes esˈkinas
tres picos	t̪ɾes ˈpikos
tres puentes	t̪ɾes ˈpwent̪es
trinidad y tobago	t̪ɾiniˈd̪ad̪ it ̪oˈbago
tuxtla gutiérrez	ˈt̪ukst̪la guˈt̪jeres
tv azteca	t̪eˈbe asˈt̪eka
tyco international	t̪ʝko int̪eɾnat̪joˈnal
ufj holdings	uf ˈxold̪ins
unión de centro democrático	uˈnjon d̪e ˈsent̪ɾo d̪emoˈkɾat̪iko
unión española	uˈnjon espaˈɲola
unión huaral	uˈnjon waˈɾal
unión magdalena	uˈnjon magd̪aˈlena
unión minas	uˈnjon ˈminas
united kingdom	uniˈt̪ed̪ kinˈgd̪om
united nations	uniˈt̪ed̪ ˈnat̪jons
united parcel service	uniˈt̪ed̪ paɾˈsel seɾˈbise
united technologies	uniˈt̪ed̪ t̪eʧnoˈloxjes
universidad de chile	unibeɾsiˈd̪ad̪ d̪e ˈʧile
universidad de guadalajara	unibeɾsiˈd̪ad̪ d̪e gwad̪alaˈxaɾa
universidad de méxico	unibeɾsiˈd̪ad̪ d̪e ˈmeksiko
universidad técnica	unibeɾsiˈd̪ad̪ ˈt̪eknika
us airways	u ˈsajɾwajs
us postal service	us posˈt̪al seɾˈbise
usa interactive	ˈusa int̪eɾakˈt̪ibe
usa networks	ˈusa ˈnet̪woɾks
uttar pradesh	uˈt̪aɾ pɾaˈd̪eʧ
vale do rio doce	ˈbale d̪o rjo ˈd̪ose
valverde del camino	balˈbeɾd̪e d̪el kaˈmino
van dam	ban d̪am
van damme	ban ˈd̪ame
van den	ban d̪en
van der	ban d̪eɾ
van dijk	ban d̪ixk
van dyke	ban d̪ʝke
van horn	ban oɾn
vanua levu	ˈbanwaˈlebu
vélez sarsfield	ˈbeles saɾsˈfjeld̪
veritas software	beˈɾit̪as ˈsofweɾ
verizon communications	beˈɾison komuniˈkat̪jons
vice versa	ˈbise ˈbeɾsa
vicente lópez	biˈsent̪e ˈlopes
villa dolores	ˈbiʝa d̪oˈloɾes
villa frontera	ˈbiʝa fɾonˈt̪eɾa
villa maría	ˈbiʝa maˈɾia
villa nueva	ˈbiʝa ˈnweba
villa regina	ˈbiʝa reˈxina
viña del mar	ˈbiɲa d̪elmaɾ
virginia beach	biɾˈxinja beˈaʧ
virginia occidental	biɾˈxinja oksid̪enˈt̪al
vis a vis	bis a bis
vivendi universal	biˈbend̪i unibeɾˈsal
volkswagen beetle	bolkˈswaxen ˈbet̪le
volkswagen bora	bolkˈswaxen ˈboɾa
volkswagen golf	bolkˈswaxen golf
volkswagen jetta	bolkˈswaxen ˈxet̪a
volkswagen passat	bolkˈswaxen paˈsat̪
volkswagen polo	bolkˈswaxen ˈpolo
volkswagen santana	bolkˈswaxensan ˈt̪ana
volkswagen vento	bolkˈswaxen ˈbent̪o
vw golf	bw golf
vw passat	bw paˈsat̪
wall street journal	wal esˈt̪ɾet̪ ˈʝoɾnal
wallis y futuna	ˈwaʝis i fuˈt̪una
walt disney	walt̪ d̪isˈnej
walt disney company	walt ̪d̪isˈnej komˈpanʝ
washington post	ˈwaʧint̪on post̪
wells fargo	wels ˈfaɾgo
west sussex	west̪ ˈsuseks
west virginia	west̪ biɾˈxinja
western digital	ˈwest̪eɾn d̪ixiˈt̪al
white horse	ˈwit̪e ˈoɾse
world bank	woɾld̪ bank
world health organization	woɾld̪ eˈalt̪ oɾganiˈsat̪jon
xl capital	sl kapiˈt̪al
zurich financial services	suˈɾiʧ finanˈsjal seɾˈbises
